333111111111111111111111111111111111111111111111111111111111111111111111111111111111                                            
i     a    d         a             a                 a                 a            1 
333111111 11111111111111111111111111111111   111111111111111111111111111111111111 11 
1     m m m m m m m m  a a a p p p a a a 11111                                  1  1 
1    1111111111111111111111111111111111111  p2                                1 1a11 
1111                                        22    111111111111111111111       1    1 
1               1   mmm      1                    1pam m m                    1   p1 
1a    22222222222222222222222222222222222222222222222222222222222222222 2     11   1 
122    2                                                            a   2     1    1 
1    222            m           11       m      1111                   22p    1  111p
1      2a       1111111      11       11111111111111   111            2 2  p  1p   11
12222  2  a     1d        11     1    1       111111               22   2     1      
1     a2    a 111                1    1   1ppp111111      1111          2   p 1      
1   2222      a 1                1        1ppp111111                    2    p1111  1
1      2   m    1                11  111111111111111          1111    222     1p    1
122    2111111                   1p 111111111111111       m   m  m      2    p1     1
1      2                         1222222222222222222    22222222222222222    p1     1
1   2222       111          p                  pp                   a        11 11111
1      2          111                                   22222222222222222   111    p1
122    2             1111111   222222222222222     22222                      1     1
1    a 2                                                     p   p   p        1 11111
1   2222                                                                      1    p1
1      2 am a m  a  1      m  m    m  1                                       1 11111
1  2222222222222222222222222222222222222222222222222222222222222222222222222221    p1
1       aaaaaaaa     c     c            m  m    m           m                c    111
222222222222222222222222222222222222222222222222222222222222222222222222222b22     11
                                                                          2o2       